+---+---+---+---+---+---+---+---+
|   |                   |       |
+   +---+---+   +---+   +   +   +
|               |   |       |   |
+---+---+---+---+   +---+---+   +
|   |                   |   |   |
+   +   +   +---+---+   +   +   +
|       |       |   |       |   |
+   +---+---+   +   +   +---+   +
|   |           |       |       |
+   +   +   +---+---+---+   +---+
|   |   |   |       |       |   |
+   +   +---+   +   +   +---+   +
|   |   |       |       |       |
+   +   +   +---+---+---+---+   +
|   |                           |
+---+---+---+---+---+---+---+---+