+---+---+---+---+---+---+---+---+
|   |       |                   |
+   +   +   +---+---+   +---+   +
|       |           |   |       |
+---+---+---+---+   +   +---+---+
|                   |           |
+   +---+---+---+---+   +---+   +
|       |       |           |   |
+---+   +   +   +---+---+---+   +
|   |   |   |                   |
+   +   +   +---+---+---+---+   +
|   |   |   |               |   |
+   +   +   +   +   +---+---+   +
|   |   |   |   |   |           |
+   +   +   +   +---+   +---+---+
|           |                   |
+---+---+---+---+---+---+---+---+
